AFA="countries/Afar.txt"
AFG="countries/Afghanistan.txt"
ALB="countries/Albania.txt"
ALT="countries/Altai.txt"
SAU="countries/Arabia.txt"
AST="countries/Australia.txt"
AUS="countries/Austria.txt"
BAH="countries/Bajookieland.txt"
LAT="countries/Baltic.txt"
BAY="countries/Bavaria.txt"
BLR="countries/Belarus.txt"
BAN="countries/Bengal.txt"
BOL="countries/BluTerritory.txt"
BOS="countries/Bosnia.txt"
BRA="countries/Brazil.txt"
ENG="countries/Briain.txt"
BUL="countries/Bulgaria.txt"
BRM="countries/Burma.txt"
BYA="countries/Buryatia.txt"
CAN="countries/Canada.txt"
CHA="countries/Chad.txt"
CHI="countries/China.txt"
COL="countries/Colombia.txt"
PRC="countries/CommunistChina.txt"
COG="countries/Congo.txt"
SOV="countries/ConnerianUnion.txt" 
CRO="countries/Croatia.txt"
CSA="countries/CSA.txt"
CUB="countries/Cuba.txt"
CZE="countries/Czechoslovakia.txt"
GER="countries/DavidReich.txt"
DEN="countries/Denmark.txt"
CKK="countries/DkBorralien.txt"
MAC="countries/DkDonau.txt"
KUB="countries/DkDonGotthia.txt"
NOR="countries/DkHyperborea.txt"
MOL="countries/DkKarpaten.txt"
ARM="countries/DkKaukasus.txt"
HRZ="countries/DkMittelafrika.txt"
KOM="countries/DkMoskowien.txt"
TAY="countries/DkNorrland.txt"
LIT="countries/DkOstland.txt"
DNZ="countries/DkPolshka.txt"
YAM="countries/DkSibirien.txt"
TMS="countries/DkTurkestan.txt"
CRI="countries/DkUkraine.txt"
TAT="countries/DkUralia.txt"
DON="countries/DongCocksex.txt"
TZN="countries/EastAfrica.txt"
EGY="countries/Egypt.txt"
CAR="countries/EQAfrica.txt"
ETH="countries/Ethiopia.txt"
FER="countries/FarEast.txt"
FIN="countries/Finland.txt"
FRA="countries/France.txt"
GAB="countries/Gabon.txt"
GRE="countries/Greece.txt"
GNA="countries/Guinea.txt"
GYA="countries/Guyana.txt"
HAW="countries/Hawaii.txt"
DOM="countries/Hispaniola.txt"
HUN="countries/Hungry.txt"
SPR="countries/Iberia.txt"
ICE="countries/Iceland.txt"
USA="countries/ImperiumAmerica.txt"
PRU="countries/Inca.txt"
RAJ="countries/India.txt"
PER="countries/Iran.txt"
IRQ="countries/Iraq.txt"
IRE="countries/Ireland.txt"
ISR="countries/Israel.txt"
AOI="countries/ItalianEastAfrica.txt"
ITA="countries/Italy.txt"
JAP="countries/Japan.txt"
JOR="countries/Jordan.txt"
CAM="countries/Kampuchea.txt"
KAZ="countries/Kazakhstan.txt"
KSH="countries/KFC.txt"
KHA="countries/Kickassia.txt"
KOR="countries/Korea.txt"
KUR="countries/Kurdistan.txt"
ARG="countries/LaPlata.txt"
LIB="countries/Liberia.txt"
LUX="countries/Luxembourg.txt"
XSM="countries/MaClique.txt"
MAD="countries/Madagascar.txt"
LBA="countries/Maghreb.txt"
MAN="countries/Manchukuo.txt"
MRT="countries/Mauritania.txt"
INS="countries/Meganesia.txt"
MEX="countries/Mexico.txt"
MON="countries/Mongolia.txt"
HOL="countries/Netherlands.txt"
NIC="countries/CentralAmerica.txt"
NGR="countries/Niger.txt"
BEL="countries/Os_Hurgundy.txt"
PAL="countries/Palestine.txt"
POL="countries/Polshka.txt"
RIF="countries/RedTerritory.txt"
ZIM="countries/Rhodesia.txt"
ROM="countries/Romania.txt"
SMI="countries/Sapmi.txt"
SWE="countries/Scandinavia.txt"
SER="countries/Serbia.txt"
SIA="countries/Siam.txt"
OVO="countries/Siberia.txt"
SOM="countries/Somalia.txt"
SAF="countries/SouthAfrica.txt"
SWI="countries/Switzerland.txt"
SYR="countries/Syria.txt"
TAN="countries/TannuTuva.txt"
BHU="countries/ThunderDragon.txt"
GEO="countries/Transcaucasia.txt"
TRA="countries/Transylvania.txt"
UZB="countries/Turkestan.txt"
TUR="countries/Turkey.txt"
UGA="countries/Uganda.txt"
UKR="countries/Ukraine.txt"
VIN="countries/Vietnam.txt"
HAN="countries/Westphalia.txt"
YAK="countries/Yakutia.txt"
YUG="countries/Yugoslavia.txt"